    MMMMMM
  .......M
 .MMMMMM.M
 . MMMMM.M
 P MMMMMMM
    .    M
MMFMMM MMM
M.MMMM M.M
M bB  Bb M
MMMMMMMMMM