MMMMMMMMMM
M........M
M.MMMMMM.M
M.MMMMMM.M
M MMMMMM M
MP      FM
M MMMMMM M
M MMMMMM.M
M bB  Bb M
MMMMMMMMMM